########
#.  ## #
#. $ $ #
#.  $  #
########

LATEX

\begin{document}
    \begin{tikzpicture}
        \begin{sokoban}[$WIDTH$, $HEIGHT$]{$FILE$}
            \node[scale=5] at (3.5, 2.5) {1};
            \node[scale=5] at (5.5, 2.5) {2};
            \node[scale=5] at (4.5, 3.5) {3};
        \end{sokoban}
    \end{tikzpicture}
\end{document}