#########
#    #  #
#   $ $@#
#  $$   #
#  #    #
#########

LATEX

\begin{document}
    \begin{tikzpicture}
        \begin{sokoban}[$WIDTH$, $HEIGHT$]{$FILE$}
            \draw[red, ->, line width=8] (7.5, 2.5) -- (6.5, 2.5);
            \draw[red, ->, line width=8] (6.5, 2.5) -- (5.5, 2.5);
        \end{sokoban}
    \end{tikzpicture}
\end{document}
