#########
#    #  #
#   $   #
#   $   #
#  #@   #
#########

LATEX

\begin{document}
    \begin{tikzpicture}
        \begin{sokoban}[$WIDTH$, $HEIGHT$]{$FILE$}
            \draw[red, ->, line width=8] (4.5, 4.5) -- (4.5, 3.5);
        \end{sokoban}
    \end{tikzpicture}
\end{document}
