####___####
#  #####  #
# $       #
#  #####  #
####___####

LATEX
\begin{document}
    \begin{tikzpicture}
        \begin{sokoban}[$WIDTH$, $HEIGHT$]{$FILE$}
            \draw[->, line width=3, red] (3, 2.5) -- (8.5, 2.5);
        \end{sokoban}
    \end{tikzpicture}
\end{document}