#######
# $ . #
#* $ .#
#######

LATEX

\begin{document}
    \begin{tikzpicture}
        \begin{sokoban}[$WIDTH$, $HEIGHT$, sok/grid]{$FILE$}
        \end{sokoban}
    \end{tikzpicture}
\end{document}