#######
#   *.#
#     #
#     #
#######

LATEX

\begin{document}
    \begin{tikzpicture}
        \begin{sokoban}[$WIDTH$, $HEIGHT$]{$FILE$}
            \draw[purple, ->, line width=8] (4.5, 1.5) -- (3.5, 1.5);
            \draw[purple, ->, line width=8] (4.5, 1.5) -- (4.5, 2.5);
        \end{sokoban}
    \end{tikzpicture}
\end{document}