#######
#   ..#
#     #
#   $ #
#######

LATEX

\begin{document}
    \begin{tikzpicture}
        \begin{sokoban}[$WIDTH$, $HEIGHT$]{$FILE$}
            \draw[red, ->, line width=8] (4.5, 3.5) -- (4.5, 4.5);
            \fill[green, fill opacity=0.4] (3, 1) rectangle +(1, 1);
            \fill[green, fill opacity=0.4] (3, 2) rectangle +(1, 1);
            \fill[green, fill opacity=0.4] (4, 2) rectangle +(1, 1);
        \end{sokoban}
    \end{tikzpicture}
\end{document}