#######
#  $..#
#     #
#     #
#######

LATEX

\begin{document}
    \begin{tikzpicture}
        \begin{sokoban}[$WIDTH$, $HEIGHT$]{$FILE$}
            \draw[purple, ->, line width=8] (3.5, 1.5) -- (2.5, 1.5);
        \end{sokoban}
    \end{tikzpicture}
\end{document}