#######
# $ ..#
# @$  #
#     #
#######

LATEX

\begin{document}
    \begin{tikzpicture}
        \begin{sokoban}[$WIDTH$, $HEIGHT$]{$FILE$}
            \fill[red, fill opacity=0.4] (1, 1) rectangle +(1, 2);
            \fill[red, fill opacity=0.4] (1, 3) rectangle +(5, 1);
        \end{sokoban}
    \end{tikzpicture}
\end{document}
